NO ./path_to_the_north_texture
SO ./path_to_the_south_texture
WE ./path_to_the_west_texture
EA ./path_to_the_east_texture
F 220,100,0
C 225,30,0

1 111111111      111111111111111
1111000000011 1111100001111
1000001110001111000000111
100000000N000001111111
1110000000000001
00111111111111111
