NO ./path_to_the_north_texture
SO ./path_to_the_south_texture
WE ./path_to_the_west_texture
EA ./path_to_the_east_texture
F 220,100,0
C 225,30,0


1111111111111
111000000011
10000011100011
100000000000
111000N0000000001
00111111111111111
