    111111
1111111111111111111111
1000000000000000000001
1001111111111111111001
100100000000N000001001
1001000000000000001001
1001000000000000000001
1001111111111111111001
1000000000000000000001
1000000000000000000001
1111111111111111111111
