111111
111111
110N01
100001
111111